NO xpm/8.xpm
SO xpm/7.xpm
EA xpm/2.xpm
WE xpm/5.xpm
C 128,128,128
F 42,42,42

11111111111111111111111111111
10000000001100000000000000001
10110000011100000000000010001
10010000000000000000000010001
10110000011100000000000210001
10000000001120000111011110001
11110111111111011100000210001
11110111111111011103030010001
11000000110101011100000010001
10000000000000001103030010001
10000000000000001102000020001
11000000110101000000000000001
11110111110101000000302000001
10000000001100000100000010001
10000000000000002000000001001
10000000001000010003030001001
10000000001101000000N20000001
10000000000100000003030000001
11111111111111111111111111111
