WE ./sprites/stone.xpm
EA ./sprites/stone.xpm
SO ./sprites/stone.xpm
NO ./sprites/stone.xpm

F   255,0,250
C   0,0,122

11111111111111111111111111111
1E000000001100000000000000001
10110000011100000000000010001
10010000000000000000000010001
10110000011100000000000010001
10000000001100000111011110001
11110111111111011100000010001
11110111111111011101010010001
11000000110101011100000010001
10000000000010001100000010001
10000000000000001101010010001
11000000110101000000000000001
11110111110101000000000000001
10000000001100000100000010001
10000000000000001010000101001
10000000001000010001010001001
10000000001101000000000000001
10000000000100000001010000001
11111111111111111111111111111
