WE  ./sprites/stone.xpm
EA  ./sprites/stone.xpm
SO  ./sprites/stone.xpm
NO  ./sprites/stone.xpm

F   255,0,250
C   0,0,122


    1111111111111111111111111111111111111111111
    1N000000000000000000000000000000000000000001
    1011111111111111111111111111111111111111111
    101
    101
     1