NO sprites/wall10.xpm 
SO sprites/wall10.xpm
EA sprites/wall10.xpm	
WE sprites/wall10.xpm
C 63,56,81
F 53,46,60

111111111111111111111111111111111111111111111111111111111111111111111111111111111111111111111111
10000000000000000000000000000000000000000000N000000000000000000000000000000000000000000000000001
100000000000000000000000000000000000000000000000000000000000000000000000000000000000000000000001
111111111111111111111111111111111110001111111111111111111111111111110000000000000000000000000111
              11111111000000000000000000000000000000000001000000000000000000000000000000000001
              11111111000000000000000000000000000000000000000000000000000000000000000000000001
              11111111000000000000000000000000000000000000000000000000000000000000000000000001
              11111111000000000000000000000000000000000001000000000000000000000000000000000001
                      10111000001111111111111111111111111 11111111111111111111111111111111111
                           111111
