NO sprites/wall10.xpm 
SO sprites/wall10.xpm
EA sprites/wall10.xpm	
WE sprites/wall10.xpm
C 63,56,81
F 53,46,60

1111111111111111111111111111111111111111111111
1000000N000000000000000000000000000000000000001
10000000000000000000000000000000000000000000001
10000000000000000000000000000000000000000000001
10000000000000000000000000000000000000000000001
10000000000000000000000000000000000000000000001
10000000000000000000000000000000000000000000001
10000000000000000000000000000000000000000000001
10000000000000000000000000000000000000000000001
10000000000000000000000000000000000000000000001
10000000000000000000000000000000000000000000001
10000000000000000000000000000000000000000000001
10000000000000000000000000000000000000000000001
10000000000000000000000000000000000000000000001
10000000000000000000000000000000000000000000001
10000000000000000000000000000000000000000000001
10000000000000000000000000000000000000000000001
10000000000000000000000000000000000000000000001
10000000000000000000000000000000000000000000001
10000000000000000000000000000000000000000000001
10000000000000000000000000000000000000000000001
10000000000000000000000000000000000000000000001
10000000000000000000000000000000000000000000001
10000000000000000000000000000000000000000000001
10000000000000000000000000000000000000000000011
 11011111111100000000111111111111111111111111
1111         11100011
1101            111
  1 
