NO	    xpm/8.xpm   
SO xpm/7.xpm
EA xpm/2.xpm	
WE xpm/5.xpm
C 128  ,   23 	    , 255    
   F     255,    42 ,   12

 1111
1000N11
 11111
1111
1101
  1                 
